00000000000000000000
00000000000000000000
00000000000000000000
00000000000000000000
00000000000000000000
0000000x11111x000000
0000000111b111000000
00000001111111000000
00000001b1a1b1000000
00000001111111000000
0000000111b111000000
0000000x11111x000000
00000000000000000000
00000000000000000000
00000000000000000000
00000000000000000000