00000000000000000000
00000000000000000000
00000000000000000000
00000000000000000000
000000000x11a0000000
00000011bbb110000000
000000x00x00x0000000
000000111b1110000000
00000011bx0100000000
00000000011100000000
00000000000000000000
00000000000000000000
00000000000000000000
00000000000000000000
00000000000000000000
00000000000000000000