00000000000000000000
00000000000000000000
00000000000000000000
00000000000000000000
0000000a110000000000
00000001bb0000000000
00000001b1000x000000
0000000001000x000000
0000000001111x000000
00000000111011000000
00000000111000000000
00000000000000000000
00000000000000000000
00000000000000000000
00000000000000000000
00000000000000000000